


NO 			assets/cris.xpm

SO      assets/naranjito.xpm

WE    assets/epti.xpm



EA 						assets/download.xpm

F 		0,0,0


C 135,206,235



11111111
10000001
10100001
100E0001
10100001
10000001
11111111