NO assets/foto-3.xpm
SO assets/pared-1-caution.xpm
WE assets/Pared-2-HELP.xpm
EA assets/foto-4.xpm

F 5,5,5
C 35,6,5

1111111111111111
1000000000000A01
1A11110111011101
1000000100010001
10111D111A111D11
100S000000000001
1111111111111111