NO assets/cris.xpm
SO assets/naranjito.xpm
WE assets/epti.xpm
EA assets/download.xpm

F 0,0,0
C 135,206,235

1111111111111111
1000000000000001
1011110111011101
1000000100010001
1011101110111011
100S000000000001
1111111111111111