NO assets/foto-3.xpm
SO assets/pared-1-caution.xpm
WE assets/Pared-2-HELP.xpm
EA assets/foto-4.xpm

F 5,5,5
C 35,6,5

111111111111
100000100001
101000100101
100S00100001
101000100101
100000100001
111111111111