


NO 		assets/cris.xpm




SO assets/naranjito.xpm

WE assets/epti.xpm

EA assets/download.xpm

F 0,0,0


C 135,206,235

1111111
10000N1
1111111