NO ./cris.xpm
SO ./cris.xpm
WE ./download.xpm
EA ./download.xpm

F 0,0,0
C 135,206,235

1111111111
1000000001
1011111101
1000000101
1011100101
1000100001
1000N00001
1111111111
