NO assets/cris.xpm
SO assets/naranjito.xpm
WE assets/epti.xpm
EA assets/download.xpm

F 0,0,0
C 135,206,235

11111111111111
10000000000001
10111111000001
10000000000000
10000000000001
10000000000001
10000000000001
10000000N00001
11111111111111