NO assets/foto-3.xpm
SO assets/pared-1-caution.xpm
WE assets/Pared-2-HELP.xpm
EA assets/foto-4.xpm

F 5,5,5


C 35,6,5

111111111111111111111
1N0000000000000000001
111111111111111111111