


NO 		assets/cris.xpm




SO assets/naranjito.xpm

WE assets/epti.xpm

EA assets/download.xpm

F 0,0,0


C 135,206,235

111111111111111111111
1N0000000000000000001
111111111111111111111