NO assets/cris.xpm
SO assets/naranjito.xpm
WE assets/epti.xpm
EA assets/download.xpm

F 0,0,0
C 135,206,235

111111
100N01
100001
100001
111111