NO assets/foto-3.xpm
SO assets/pared-1-caution.xpm
WE assets/Pared-2-HELP.xpm
EA assets/foto-4.xpm

F 5,5,5
C 35,6,5

        1111111111111111111111111
        1A000000001100000000000A1
        1011000001110000000000001
        1001000000D00000000000001
111111111011000001110000000000001
100000000000000001110111111111111
111101111111110111000A0010001
11110111111111D11101010010001
11000000110101011100000010001
1A0000000000000000000000D0001
10000000000000001101010010001
1100A001110101011111011110N0111
11110111 1110101 101111010001
11111111 1111111 111111111111